{
  "id": "floor_07",
  "name": "The Cat Tower",
  "floor": 7,
  "starThresholds": [90, 55, 35],
  "undoLimit": 3,
  "grid": [
    "############",
    "#..........#",
    "#.C.C......#",
    "#.....##...#",
    "#..#.......#",
    "#......C...#",
    "#.T.T......#",
    "#.....##...#",
    "#..#.......#",
    "#......T...#",
    "#...P......#",
    "############"
  ]
}
