{
  "id": "floor_06",
  "name": "The Maze Café",
  "floor": 6,
  "starThresholds": [80, 50, 32],
  "undoLimit": 3,
  "grid": [
    "############",
    "#..........#",
    "#.C..#..C..#",
    "#....#.....#",
    "#.##...##..#",
    "#..........#",
    "#..T.#.T...#",
    "#....#.....#",
    "#.##...##..#",
    "#..........#",
    "#.....P....#",
    "############"
  ]
}
