{
  "id": "floor_03",
  "name": "Nap Room",
  "floor": 3,
  "starThresholds": [50, 30, 18],
  "undoLimit": 4,
  "grid": [
    "##########",
    "#........#",
    "#.C..C...#",
    "#...##...#",
    "#........#",
    "#.T....T.#",
    "#...##...#",
    "#........#",
    "#...P....#",
    "##########"
  ]
}
