{
  "id": "floor_10",
  "name": "Rooftop Garden",
  "floor": 10,
  "starThresholds": [140, 80, 50],
  "undoLimit": 3,
  "grid": [
    "##############",
    "#............#",
    "#.C....C.....#",
    "#...###......#",
    "#........#...#",
    "#.C..........#",
    "#...T.###.T..#",
    "#............#",
    "#........#...#",
    "#..T.........#",
    "#...###......#",
    "#..........C.#",
    "#.....P...T..#",
    "##############"
  ]
}
