{
  "id": "floor_02",
  "name": "The Cozy Corner",
  "floor": 2,
  "starThresholds": [40, 22, 14],
  "undoLimit": 5,
  "grid": [
    "#########",
    "#.......#",
    "#.C.....#",
    "#...#...#",
    "#.....T.#",
    "#...#...#",
    "#.....C.#",
    "#..P..T.#",
    "#########"
  ]
}
