{
  "id": "floor_09",
  "name": "The Penthouse",
  "floor": 9,
  "starThresholds": [120, 70, 45],
  "undoLimit": 3,
  "grid": [
    "#############",
    "#...........#",
    "#.C...C..C..#",
    "#...##......#",
    "#.......#...#",
    "#...........#",
    "#.T..##..T..#",
    "#...........#",
    "#.......#...#",
    "#...T.......#",
    "#...........#",
    "#.....P.....#",
    "#############"
  ]
}
