{
  "id": "floor_04",
  "name": "The Lounge",
  "floor": 4,
  "starThresholds": [60, 35, 22],
  "undoLimit": 4,
  "grid": [
    "###########",
    "#.........#",
    "#.C.......#",
    "#...###...#",
    "#.........#",
    "#.T.#.T...#",
    "#.........#",
    "#...###...#",
    "#.......C.#",
    "#....P....#",
    "###########"
  ]
}
