{
  "id": "floor_08",
  "name": "Whisker Wing",
  "floor": 8,
  "starThresholds": [100, 60, 40],
  "undoLimit": 3,
  "grid": [
    "#############",
    "#...........#",
    "#.C...C.....#",
    "#.....###...#",
    "#..#........#",
    "#...........#",
    "#.T...T.....#",
    "#.....###...#",
    "#..#........#",
    "#.......C.T.#",
    "#...........#",
    "#....P......#",
    "#############"
  ]
}
