{
  "id": "floor_05",
  "name": "Cushion Chaos",
  "floor": 5,
  "starThresholds": [70, 42, 28],
  "undoLimit": 3,
  "grid": [
    "###########",
    "#.........#",
    "#.C...C...#",
    "#..##.....#",
    "#.........#",
    "#.T.#.T...#",
    "#.........#",
    "#.....##..#",
    "#...C...T.#",
    "#....P....#",
    "###########"
  ]
}
